%%%%%%%%%%%%%%%%%%%%%%%
%$   $$$$$ $      $   %
%$   $$$$$$$$  $ $$   %
%$  $$  $B$$ $   $    %
%   $ $  $ $       $  %
%   $  $ $ $  $ $   $ %
%$$$ $ $   $  $ $     %
%%%%%%%%%%%%%%%%%%%%%%%