%%%%%%%%%%%%
%B%        %
%%         %
%          %
%          %
%     R    %
%%%%%%%%%%%%