%%%%%%%
% B E %
% E   %
%%%%%%%
