%%%%%%%%%
% BB    %
%      %%
%     %E%
%%%%%%%%%