%%%%%%%%%%%%%%%%%%%%%%%
%    $$$$$$$$$$$$$    %
%    $$$$$$$$$$$$     %
% $$$$$$$$B$$$$$$     %
%      $$$$$$$$$$$$   %
%     $$$$$$$$$$$$$   %
%%%%%%%%%%%%%%%%%%%%%%%