%%%%%%%
% B E %
%     %
%%%%%%%
