%%%%%%%%%%%%%%
%B%   E R    %
%%%%%%%%%%%%%%