%%%%%%%
%B    %
%  E  %
%%%%%%%