%%%%%%%%%%%%
%          %
%          %
%          %
% $       %%
%B       %R%
%%%%%%%%%%%%