%%%%%%%%%%
%$ E B EE%
%    E   %
%    E   %
%%%%%%%%%%
