%%%%%%%%%%%%%%%
%B%%    ER    %
%%%%%%%%%%%%%%%